19 18 18 18 24 1 1 1 1 1 1 1 1 1 1 1 1 1 1 1 1 1 1 1 1 135 172 172 172 172 172 172 172 172 172 172 172 172 253 254 276 277 172 253 254 276 277 137 1 1 
18 18 18 19 24 1 1 1 1 1 1 1 1 1 1 1 1 1 1 1 1 1 1 1 1 146 240 234 235 236 234 235 236 240 233 258 260 146 255 256 278 279 146 255 256 278 279 146 1 2 
18 18 18 18 24 1 1 1 1 1 1 1 1 1 1 1 1 1 1 1 1 1 1 1 1 146 241 237 238 239 237 238 239 241 233 230 231 146 244 244 244 244 146 244 244 244 244 146 1 1 
18 19 18 18 24 1 1 1 1 1 1 1 1 1 1 1 1 1 1 1 1 1 1 1 1 146 242 231 230 231 230 231 230 242 233 231 270 146 261 262 263 244 146 244 261 262 263 146 1 2 
18 18 18 18 24 1 1 1 1 1 1 1 1 1 1 1 1 1 1 1 1 1 1 1 1 146 231 230 231 230 231 230 231 230 233 230 271 146 264 265 266 244 146 244 264 265 266 146 1 1 
18 18 18 18 27 1 1 1 1 1 1 1 1 1 1 1 1 1 1 1 1 1 1 1 1 146 221 233 233 233 233 233 233 233 233 231 230 146 244 244 244 244 146 244 244 244 244 146 2 1 
19 18 19 24 1 1 1 1 1 1 1 1 2 1 1 1 1 1 1 2 1 1 1 1 1 146 231 230 231 230 231 230 231 230 245 230 245 146 244 244 244 244 146 244 244 244 270 146 1 1 
18 18 18 24 2 1 1 1 1 1 1 1 1 1 1 1 1 1 1 1 1 1 1 1 1 146 230 231 230 231 230 231 230 231 246 231 246 146 229 244 244 224 146 229 244 244 271 146 1 1 
18 19 24 1 1 1 1 1 1 1 135 172 172 172 172 172 204 205 172 172 172 172 172 172 172 172 172 193 172 172 172 172 172 172 172 172 172 160 172 193 172 172 172 172 193 172 172 146 2 1 
18 24 1 1 1 1 1 1 1 1 146 232 232 232 232 232 232 232 232 232 232 232 232 232 232 232 232 232 232 232 232 232 232 232 232 232 232 232 232 232 232 232 232 232 232 232 232 146 1 1 
18 24 1 2 1 1 2 1 1 1 146 232 232 232 232 232 232 232 232 232 232 232 232 232 232 232 232 232 232 232 232 232 232 232 232 232 232 232 232 232 232 232 232 232 232 232 232 146 1 1 
18 24 1 1 1 1 1 1 1 1 146 232 232 232 232 232 232 232 232 232 232 232 232 232 232 232 232 232 232 232 232 232 232 232 232 232 232 232 232 232 232 232 232 232 232 232 232 146 1 1 
19 24 2 1 1 1 1 1 1 1 146 232 232 135 172 172 172 172 172 172 172 172 172 172 172 172 172 172 172 172 172 136 172 172 172 172 137 232 232 232 232 232 135 172 172 172 172 149 1 1 
18 24 1 1 1 1 1 1 1 1 146 232 232 146 0 0 0 0 0 0 0 0 0 0 0 0 0 0 0 0 0 146 182 191 167 167 221 232 232 232 232 232 221 167 167 191 182 146 1 1 
18 24 1 1 135 172 172 172 172 201 146 172 201 147 172 172 172 136 172 172 137 0 0 0 0 0 0 0 0 0 0 146 183 167 167 184 134 232 232 232 232 232 134 184 167 167 183 146 1 1 
18 24 1 1 146 182 167 182 167 202 146 187 202 146 182 167 191 146 182 191 147 173 227 171 136 172 172 172 136 172 172 160 136 172 172 172 148 232 232 232 232 232 146 247 248 249 172 149 2 1 
26 27 1 1 146 183 167 183 167 167 146 232 232 146 183 167 167 146 183 167 146 232 232 232 147 182 167 184 146 182 167 184 146 182 167 184 146 232 232 232 232 232 146 250 251 252 232 146 1 1 
1 1 1 16 146 167 167 167 167 167 193 232 232 146 167 167 167 146 167 167 146 232 232 232 147 183 167 167 146 183 167 167 146 183 167 167 146 232 232 232 232 232 146 232 243 232 232 146 2 1 
1 1 1 1 146 182 167 182 167 167 146 232 232 146 167 167 184 146 167 184 146 232 232 232 146 167 167 191 146 167 167 191 146 167 167 191 146 232 232 232 232 232 146 244 244 244 272 146 1 1 
1 1 1 1 146 183 167 183 167 167 159 172 172 160 221 172 172 160 221 172 161 232 232 232 159 233 221 171 160 233 221 171 160 233 221 171 161 232 232 232 232 232 146 244 244 244 272 146 1 2 
1 1 16 1 146 167 167 167 167 167 167 167 167 232 232 232 232 232 232 232 232 232 232 232 232 232 232 232 232 232 232 232 232 232 232 232 232 232 232 232 232 232 193 244 244 244 273 146 1 1 
1 1 1 1 146 167 167 167 167 167 167 167 167 232 232 232 232 232 232 232 232 232 232 232 232 232 232 232 232 232 232 232 232 232 232 232 232 232 232 232 232 232 146 244 244 244 135 161 1 1 
1 16 1 1 147 201 172 201 137 167 167 167 167 232 232 232 232 232 232 232 232 232 232 232 232 232 232 232 232 232 232 232 232 232 232 232 232 232 232 232 232 232 146 224 225 229 146 1 1 1 
1 1 1 1 146 202 232 202 159 172 172 172 137 232 232 232 232 232 232 135 172 172 173 232 232 232 232 171 172 172 137 232 232 232 232 232 232 232 232 135 247 248 249 280 247 248 249 269 280 137 
1 1 16 1 146 232 232 232 232 232 232 232 146 232 232 232 232 232 232 146 415 401 402 232 232 232 232 401 402 415 146 232 232 232 232 232 232 232 232 146 250 251 252 232 250 251 252 232 257 146 
2 1 1 1 193 232 232 232 232 232 232 232 146 232 232 232 232 232 232 146 1 2 12 232 232 232 232 2 2 1 146 232 232 232 232 232 232 232 232 146 232 243 232 232 232 243 232 232 232 146 
1 2 1 1 146 232 224 229 135 172 172 172 161 232 232 232 232 232 232 158 2 2 232 232 2 1 232 232 1 2 158 232 232 232 232 232 232 232 232 146 232 244 244 244 244 244 244 244 257 146 
1 1 1 2 146 232 232 232 146 232 232 232 232 232 232 232 232 232 232 232 232 232 232 1 2 1 2 232 232 232 232 232 232 232 232 232 232 232 232 146 232 244 244 244 244 244 244 244 232 146 
1 16 1 1 147 172 436 172 201 172 436 172 137 232 232 232 232 232 232 232 232 232 232 2 1 2 1 232 232 232 232 232 232 232 232 232 232 232 232 193 232 244 244 244 244 244 244 244 232 146 
2 1 1 2 146 258 259 260 202 258 259 260 146 232 232 232 232 232 232 134 2 1 232 232 2 2 232 232 1 2 134 232 232 232 232 232 232 232 232 146 232 232 232 232 232 232 264 265 266 146 
1 1 1 1 146 232 232 232 232 232 232 232 219 232 232 232 232 232 232 146 2 2 14 232 232 232 232 15 2 2 146 232 232 232 232 232 232 232 232 146 224 225 225 225 225 229 135 172 172 161 
135 172 172 172 149 437 232 232 232 232 232 437 146 232 232 232 232 232 232 146 415 407 408 232 232 232 232 407 408 415 146 232 232 232 232 232 135 172 172 172 172 172 172 172 172 172 149 1 1 1 
146 224 225 229 146 440 441 232 232 232 438 439 146 232 232 232 232 232 232 159 172 172 173 232 232 232 232 171 172 172 161 232 232 232 232 232 221 197 196 197 196 197 196 197 196 197 146 1 1 1 
146 232 232 232 146 446 447 232 232 232 442 443 146 232 232 232 232 232 232 232 232 232 232 232 232 232 232 232 232 232 232 232 232 232 232 232 221 196 197 394 395 196 395 394 197 196 146 1 1 1 
146 232 232 232 146 448 449 232 232 232 444 445 146 232 232 232 232 232 232 232 232 232 232 232 232 232 232 232 232 232 232 232 232 232 232 232 146 197 196 224 225 197 224 225 196 197 146 1 1 1 
146 232 232 232 159 172 172 172 219 172 172 172 161 232 232 232 232 232 232 232 232 232 232 232 232 232 232 142 144 144 144 144 144 145 232 232 146 196 197 394 395 196 395 394 197 196 146 1 1 1 
146 232 232 232 232 232 232 232 232 232 232 232 232 232 232 232 232 232 232 232 232 232 232 232 232 232 232 154 167 167 167 167 167 169 232 232 146 197 196 197 196 197 196 197 196 197 146 1 1 1 
146 232 232 232 232 232 232 232 232 232 232 232 232 232 232 232 232 232 232 232 232 232 232 232 232 232 232 154 167 167 167 167 167 169 232 232 146 196 197 394 395 196 395 394 197 196 146 1 2 2 
146 232 232 232 232 232 232 232 232 232 232 232 232 232 232 232 232 232 232 232 232 232 232 232 232 232 232 154 167 167 167 167 167 169 232 232 146 197 196 224 229 197 224 229 196 197 146 1 2 2 
147 172 172 172 172 172 172 173 167 167 167 167 167 135 172 172 172 142 145 219 142 145 232 232 232 232 232 178 179 179 179 179 179 181 232 232 146 196 197 394 395 196 395 394 197 196 146 1 2 2 
146 167 167 167 167 167 167 167 167 167 167 167 167 146 396 396 396 178 181 220 178 181 137 232 232 232 232 232 232 232 232 232 232 232 232 232 146 197 196 197 196 197 196 197 196 197 146 1 2 2 
146 167 393 167 134 167 393 167 134 167 393 167 135 146 167 167 167 167 167 167 167 187 146 227 137 232 232 232 232 232 232 232 232 232 232 232 146 196 197 196 197 196 197 196 197 196 146 1 2 2 
146 188 188 188 146 188 188 188 146 188 188 188 146 146 167 167 167 167 167 167 167 167 146 0 146 232 232 232 232 232 232 232 232 232 232 232 146 197 196 197 196 197 196 197 196 197 159 172 172 137 
146 167 393 167 158 167 393 167 158 167 393 167 159 146 217 167 167 167 167 167 167 217 146 0 147 172 436 172 436 172 436 137 232 232 232 232 146 196 197 196 197 196 197 196 197 196 197 196 197 146 
146 167 167 167 167 167 167 167 167 167 167 167 167 146 218 167 167 167 167 167 167 218 146 0 146 186 167 186 167 186 167 146 232 232 232 232 146 215 435 435 435 216 135 172 194 199 200 172 219 146 
146 167 167 167 167 167 167 167 167 167 167 167 167 146 172 172 172 172 172 172 172 172 161 0 146 393 167 393 167 393 167 146 232 232 232 232 146 196 197 196 197 196 146 418 195 419 419 196 220 146 
146 172 193 172 172 172 172 172 172 172 172 172 201 147 0 0 0 0 0 0 0 0 0 0 146 167 167 167 167 167 167 221 232 232 232 232 146 197 196 197 196 197 219 197 196 197 196 197 196 146 
146 167 167 224 225 225 225 225 225 225 225 229 202 147 0 0 0 0 0 0 0 0 0 0 146 422 167 167 167 167 167 146 232 232 232 232 147 172 172 172 172 172 173 196 197 196 197 196 217 146 
146 167 167 167 167 167 167 167 167 167 167 167 167 147 0 0 0 0 0 0 0 0 0 0 146 450 450 450 450 450 450 146 232 232 232 232 146 0 0 0 0 0 227 197 196 197 215 226 214 146 
159 172 172 172 172 172 172 172 172 172 172 172 172 172 172 172 172 172 172 172 172 172 172 172 172 172 172 172 172 172 172 172 172 204 205 172 172 172 172 172 172 172 172 172 172 172 172 172 172 161 
