19 18 18 18 18 18 18 18 18 18 18 18 19 18 18 18 18 18 18 18 18 19 18 18 18 18 18 18 18 24 1 2 1 1 1 1 135 0 0 0 0 0 0 0 0 0 0 137 1 1 
18 18 18 18 19 18 18 18 18 18 19 18 18 18 18 19 18 18 18 18 18 18 18 18 18 18 18 18 18 24 1 1 1 1 1 1 146 0 0 0 0 0 0 0 0 0 0 146 1 2 
18 18 18 18 18 18 18 19 18 18 18 18 18 18 18 18 18 18 18 18 18 18 19 18 18 19 18 18 18 24 1 1 2 1 1 1 146 0 0 0 0 0 0 0 0 0 0 146 1 1 
18 19 18 18 19 18 18 18 18 18 18 19 18 18 19 18 18 18 19 18 18 18 18 19 18 18 18 18 18 24 1 2 1 1 1 1 146 0 0 0 0 0 0 0 0 0 0 146 1 2 
18 18 18 18 18 18 18 18 19 18 18 18 18 18 18 18 18 19 18 18 18 19 18 18 18 18 19 18 18 19 22 1 1 2 1 1 146 0 0 0 0 0 0 0 0 0 0 146 1 1 
18 18 18 18 18 26 26 26 26 26 26 26 26 26 26 26 26 26 26 26 26 26 26 26 26 26 26 26 26 26 27 1 1 1 1 1 146 0 0 0 0 0 0 0 0 0 0 146 2 1 
18 18 19 18 27 1 1 1 1 1 1 1 2 1 1 1 1 1 1 2 1 1 1 1 1 1 1 1 1 1 1 1 1 1 1 1 159 172 172 173 204 205 171 172 172 172 172 161 1 1 
18 18 18 27 2 1 1 1 1 1 1 1 1 4 5 5 6 1 1 1 1 1 1 2 1 1 1 2 1 1 16 1 1 1 1 1 1 1 1 146 167 167 146 1 1 1 1 1 1 1 
18 19 24 1 1 1 1 1 1 1 1 1 1 7 16 17 8 1 1 1 1 1 16 1 1 1 1 1 1 1 1 1 2 1 1 16 1 2 1 146 167 167 146 1 1 1 16 1 2 1 
18 18 27 1 1 1 1 1 1 1 1 1 1 9 10 10 11 1 1 1 1 1 1 1 1 1 1 1 1 1 1 1 1 1 1 1 1 1 1 146 167 167 159 172 172 137 1 1 1 1 
18 24 1 2 1 1 2 1 135 172 172 172 172 172 172 172 172 172 172 172 134 172 172 172 172 172 172 136 172 172 201 134 1 1 1 1 1 1 16 146 167 167 167 167 167 146 1 16 1 1 
18 24 1 1 1 1 1 1 146 0 0 0 0 0 0 0 0 0 0 0 146 182 167 182 167 167 167 146 167 187 202 146 1 2 1 16 1 1 1 146 167 167 167 167 167 146 1 1 1 1 
19 24 2 1 1 1 16 1 146 0 0 0 0 0 0 0 0 0 0 0 146 183 167 183 167 167 167 193 167 167 167 146 1 1 1 1 1 1 1 159 172 172 137 167 167 146 2 1 1 1 
18 24 1 1 1 1 1 1 146 0 0 0 0 0 0 0 0 0 0 0 146 167 167 167 167 167 167 146 167 167 167 146 1 1 2 1 1 1 1 16 1 1 146 167 167 146 1 16 1 1 
18 24 1 1 134 172 172 172 146 172 172 172 134 172 172 172 134 172 172 172 146 167 167 167 167 167 167 146 206 207 167 146 1 1 1 1 1 1 1 1 1 1 146 167 167 146 1 1 1 1 
18 27 1 1 146 182 167 191 146 182 167 191 146 182 167 191 146 182 167 191 147 173 220 171 136 172 172 172 136 172 172 172 136 171 172 172 136 172 172 172 137 1 146 167 167 146 1 1 2 1 
27 1 1 1 146 183 167 167 146 183 167 167 146 183 167 167 146 183 167 167 146 167 167 167 147 182 167 184 146 182 167 184 146 182 167 167 146 182 167 184 146 172 161 167 167 159 137 1 1 1 
1 1 1 16 146 167 167 184 146 167 167 184 146 167 167 184 146 167 167 184 146 167 167 167 147 183 167 167 146 183 167 167 146 183 167 167 146 183 167 167 146 167 167 167 167 167 146 1 2 1 
1 1 1 1 146 221 171 172 160 221 171 172 160 221 171 172 160 221 171 172 161 167 167 167 146 167 167 191 146 167 167 191 146 167 167 191 146 167 167 191 146 167 167 167 167 167 146 1 1 1 
1 1 1 1 146 167 167 167 167 167 167 167 167 167 167 167 167 167 167 167 167 167 167 167 159 173 221 171 160 173 221 171 160 173 221 171 159 173 221 171 161 167 167 167 167 167 146 1 1 2 
1 1 16 1 146 167 167 167 167 167 167 167 167 167 167 167 167 167 167 167 167 167 167 167 167 167 167 167 167 167 167 167 167 167 167 167 167 167 167 167 167 167 167 167 167 167 146 2 1 1 
1 1 1 1 146 167 167 167 167 167 167 167 167 167 167 167 167 167 167 167 167 167 167 167 167 167 167 167 167 167 167 167 167 167 167 167 167 167 167 167 167 167 167 167 167 167 146 1 1 1 
1 16 1 1 146 221 171 172 137 221 171 172 172 137 167 167 167 135 221 171 172 137 221 171 172 137 221 171 172 137 167 167 167 134 221 171 172 137 221 171 172 136 172 172 172 172 161 1 1 1 
1 1 1 1 146 167 167 184 146 167 167 167 191 146 167 167 167 146 167 167 184 146 167 167 184 146 167 167 191 146 167 167 167 146 167 167 191 146 167 167 191 146 1 16 1 1 1 1 1 1 
1 1 16 1 146 182 167 167 147 182 167 167 167 146 167 167 167 146 182 167 167 146 182 167 167 146 182 167 167 146 167 167 167 146 182 167 167 146 182 167 167 146 1 2 1 16 1 1 2 1 
2 1 1 1 146 183 167 191 147 183 167 167 184 146 140 221 139 146 183 167 191 146 183 167 191 146 183 167 167 146 140 221 139 146 183 167 184 146 183 167 184 146 1 1 1 1 2 1 1 1 
1 2 1 1 159 172 137 222 222 222 222 136 172 136 181 220 178 146 172 172 172 172 172 136 199 200 194 166 184 146 181 220 178 146 172 136 172 172 172 172 172 146 1 16 1 1 1 1 1 1 
1 1 1 2 1 1 146 223 223 223 223 146 0 146 167 167 167 146 213 214 197 196 197 158 196 197 195 198 203 146 167 167 167 146 167 146 1 1 1 1 1 146 1 1 1 16 1 1 1 1 
1 16 1 1 16 1 146 167 167 167 167 146 0 146 167 167 167 146 196 197 196 197 196 219 197 196 197 196 197 146 167 167 167 146 167 146 1 1 1 1 1 158 2 1 1 1 1 1 2 1 
2 1 1 2 1 1 146 167 167 167 167 159 172 161 167 167 167 146 172 213 226 226 214 134 196 197 196 197 196 146 167 167 167 146 167 146 1 1 1 1 1 193 1 1 2 1 2 1 1 1 
1 1 1 1 1 1 146 167 167 167 167 167 220 167 167 167 167 146 197 196 197 196 197 159 172 173 219 171 172 146 167 167 167 159 172 161 1 1 1 1 1 134 1 1 1 1 1 1 1 1 
135 172 172 172 136 172 146 186 186 186 167 135 172 137 167 167 167 146 196 197 196 197 196 197 196 197 196 197 196 146 167 167 167 167 220 193 1 1 1 1 1 146 201 173 193 171 137 2 1 1 
146 167 167 167 146 0 146 393 393 393 167 146 0 146 167 167 167 146 197 196 197 196 197 196 197 196 197 196 197 146 167 167 167 167 171 136 172 172 172 172 172 146 202 34 34 34 146 1 1 1 
146 167 134 167 146 0 159 172 172 172 172 161 0 146 167 167 167 146 196 395 394 395 394 197 394 395 394 395 196 146 167 167 167 167 167 146 0 0 0 0 0 146 34 34 34 34 146 1 2 1 
146 167 146 167 146 0 0 0 0 0 0 0 0 146 167 167 167 146 197 224 225 225 224 196 224 225 225 224 197 146 167 167 167 167 167 146 0 0 0 0 0 146 34 34 34 35 146 1 1 1 
146 167 146 167 159 172 172 172 172 172 172 172 139 145 167 167 167 146 196 395 394 395 394 197 394 395 394 395 196 146 167 167 167 167 167 147 172 172 172 172 172 172 172 172 172 172 146 16 1 2 
146 167 146 167 167 167 167 167 167 167 167 167 178 181 167 167 167 146 197 196 197 196 197 196 197 196 197 196 197 146 167 167 167 167 171 161 167 167 167 167 167 167 167 167 167 167 146 1 1 1 
146 167 158 167 167 167 167 167 167 167 167 167 221 220 167 167 167 159 172 172 172 172 136 221 136 172 172 172 172 161 167 167 167 167 220 221 167 167 167 167 167 167 167 167 167 167 146 1 2 1 
146 167 167 167 167 167 167 134 167 167 134 167 142 145 167 167 167 167 167 167 167 167 158 220 158 167 167 167 167 167 167 167 167 167 170 137 167 167 167 167 167 167 167 167 167 167 146 1 1 1 
146 172 172 172 172 172 172 153 167 167 150 172 179 176 172 137 167 167 167 142 145 167 167 167 167 167 142 145 167 167 167 167 167 167 167 147 171 219 135 172 172 172 172 137 167 167 146 2 16 1 
146 35 34 228 34 228 34 158 167 167 158 34 34 34 35 146 167 167 167 178 181 167 167 167 167 167 178 181 167 167 167 167 167 135 172 146 187 167 146 34 34 34 34 219 167 167 146 1 1 1 
146 34 34 34 34 34 34 34 34 34 34 34 34 34 35 146 167 167 167 167 167 167 167 167 167 167 167 167 167 167 167 167 167 146 167 146 167 167 146 34 34 34 217 134 167 167 146 1 1 1 
146 189 34 34 189 34 34 34 34 34 34 189 34 146 172 161 227 172 172 137 172 172 172 172 172 137 167 167 167 167 167 167 167 146 167 147 173 227 146 206 207 34 218 146 167 167 146 2 1 1 
146 34 34 34 34 34 228 34 34 228 34 34 34 146 0 0 0 0 0 146 0 0 0 0 0 146 167 167 167 135 172 227 172 160 172 161 0 0 147 172 172 172 172 146 167 167 146 1 2 16 
146 189 34 34 189 34 34 34 34 34 34 189 34 146 0 0 0 0 0 146 0 0 0 0 0 142 140 220 139 145 0 0 0 0 0 0 0 0 146 206 207 34 34 219 167 167 146 1 1 1 
146 34 34 34 34 34 228 34 34 228 34 34 34 146 0 0 0 0 0 146 0 0 0 0 0 178 181 193 178 181 0 0 0 0 0 0 0 0 146 34 34 34 34 146 167 167 146 1 1 1 
159 172 172 172 172 172 172 172 172 172 172 172 172 160 172 172 172 172 172 146 0 0 0 0 0 0 146 1 146 0 0 0 0 0 0 0 0 0 146 217 34 34 217 146 167 167 146 1 2 1 
1 1 1 1 1 1 1 16 1 1 1 2 1 1 2 1 1 1 1 158 172 172 172 172 172 172 161 2 159 172 172 172 172 172 172 172 172 172 149 218 34 34 218 146 167 167 146 1 1 1 
1 2 1 16 1 2 1 1 1 2 1 1 1 16 1 1 2 1 1 16 1 1 1 16 1 1 1 1 1 2 1 16 1 1 1 16 1 1 159 172 172 172 172 172 172 172 161 1 16 1 
1 1 1 1 1 1 1 1 1 1 1 1 1 1 1 1 1 1 1 1 1 2 1 1 1 1 2 1 1 1 1 1 2 1 1 2 1 1 1 1 2 1 1 1 2 1 1 1 2 1 
