136 172 172 172 172 172 172 172 172 172 172 172 172 172 172 172 172 172 172 172 172 172 172 172 172 172 172 172 172 172 172 172 172 172 172 172 172 172 172 172 172 172 172 149 1 146 172 172 172 137 
146 1 1 1 1 1 1 1 1 1 1 1 1 1 1 1 1 1 1 1 1 1 1 1 1 1 1 1 1 1 1 1 1 1 1 1 1 1 1 1 1 1 1 146 220 146 1 1 1 146 
146 1 1 1 1 1 1 1 1 1 1 1 1 1 1 1 1 1 1 1 1 1 1 1 1 1 1 1 1 1 1 1 1 1 1 1 1 1 1 1 135 172 172 161 193 159 172 137 1 146 
146 1 1 1 167 167 167 167 167 167 167 167 167 167 1 1 1 1 1 135 172 172 172 172 193 172 172 172 172 137 1 1 1 1 1 1 1 1 1 1 146 258 259 260 167 167 422 146 1 146 
146 1 1 167 167 232 232 232 232 232 232 232 232 167 167 1 1 1 1 146 232 232 232 232 232 232 232 232 232 146 1 1 1 1 1 1 1 1 1 1 146 167 167 167 167 167 167 146 1 146 
146 1 1 167 232 232 451 452 453 454 455 456 457 232 167 1 1 1 1 146 232 232 232 232 232 232 232 232 232 146 1 1 1 1 1 1 1 1 1 1 146 167 393 167 167 393 167 146 1 146 
146 1 1 167 232 232 458 459 460 461 462 463 464 232 167 1 142 172 172 160 172 172 137 232 232 232 135 253 254 148 172 172 172 172 172 172 172 172 137 1 146 188 188 188 188 188 188 146 1 146 
146 1 1 167 232 232 465 466 467 468 469 470 471 232 167 1 146 185 186 185 186 185 146 232 232 232 146 255 256 146 34 228 34 228 34 34 189 34 159 172 149 167 393 167 167 393 167 146 1 146 
146 1 1 167 232 232 472 473 473 474 475 476 232 232 167 1 146 167 393 167 393 167 146 232 232 232 146 232 232 146 35 34 34 34 34 34 34 34 189 34 146 167 167 167 167 167 167 146 1 146 
146 1 1 167 167 232 232 232 232 232 232 232 232 167 167 1 146 167 186 185 186 167 146 232 232 232 146 232 400 146 34 228 34 228 34 34 189 34 34 34 146 167 167 167 167 167 167 146 1 146 
146 1 1 1 167 167 167 167 167 167 167 167 167 167 1 1 146 167 393 167 393 167 146 232 232 232 146 232 400 146 34 34 34 34 228 34 34 34 189 34 146 144 145 193 142 144 144 146 1 146 
146 1 1 1 1 1 1 1 1 1 1 1 1 1 1 1 147 172 172 219 172 172 161 232 232 232 159 219 172 160 172 219 172 172 172 172 172 172 172 172 161 179 181 220 178 179 179 146 1 146 
146 1 1 1 1 1 1 1 1 1 1 1 1 1 1 1 146 232 232 232 232 232 232 232 232 232 232 232 232 232 232 232 232 232 232 232 232 232 232 232 232 232 232 232 258 259 260 146 1 146 
146 1 1 1 1 1 135 172 172 172 204 205 172 172 172 172 161 232 232 232 232 232 232 232 232 232 232 232 232 232 232 232 232 232 232 232 232 232 232 232 232 232 232 232 232 232 232 146 1 146 
146 1 1 1 1 1 146 232 232 232 232 232 232 232 232 232 232 232 232 232 232 232 142 144 144 144 144 145 232 232 232 232 232 232 232 232 232 232 232 232 232 232 232 232 232 232 232 146 1 146 
146 1 1 1 1 1 159 137 232 232 232 232 232 232 232 232 232 232 232 232 232 232 154 167 167 167 167 169 232 232 232 135 221 172 172 136 221 172 172 136 221 172 172 136 221 172 172 149 1 146 
146 1 1 1 1 1 1 146 232 232 232 232 232 232 232 232 232 232 232 232 232 232 178 179 179 179 179 181 232 232 232 146 167 167 167 146 167 167 167 146 167 167 167 146 167 167 167 146 1 146 
146 1 1 1 1 1 1 146 232 232 232 232 232 232 232 232 232 232 232 232 232 232 232 232 232 232 232 232 232 232 232 146 167 167 167 146 167 167 167 146 167 167 167 146 167 167 167 146 1 146 
146 1 1 1 1 1 1 146 232 232 232 232 232 232 232 232 232 232 232 232 232 232 232 232 232 232 232 232 232 232 232 146 182 167 184 146 182 167 167 146 182 167 184 146 182 167 184 146 1 146 
146 1 1 1 1 1 135 160 194 172 172 172 172 172 136 172 172 172 172 172 172 137 232 232 232 232 232 232 232 232 232 146 183 167 191 146 183 167 191 146 183 167 191 146 183 167 191 146 1 146 
146 1 1 1 1 1 146 419 195 418 419 419 197 196 219 197 196 197 196 197 196 146 232 232 232 232 232 232 232 232 232 147 172 172 172 148 172 172 172 148 172 172 172 148 172 172 172 149 1 146 
146 1 1 1 1 1 146 197 196 197 196 197 196 197 146 215 435 435 435 216 171 161 232 232 232 232 232 232 232 232 232 146 182 167 191 146 182 167 191 146 182 167 191 146 182 167 191 146 1 146 
146 1 1 1 1 1 146 196 197 196 197 196 197 196 146 196 197 196 197 196 197 196 197 196 197 134 232 232 232 232 232 146 183 167 167 146 183 167 167 146 183 167 167 146 183 167 167 146 1 146 
146 1 1 1 1 1 146 197 196 197 196 197 196 197 146 395 394 395 394 197 196 395 394 395 394 146 232 232 232 232 232 146 167 167 184 146 167 167 184 146 167 167 184 146 167 167 184 146 1 146 
146 1 1 1 1 1 146 196 197 196 197 196 197 217 146 224 225 225 225 229 197 224 225 225 229 146 232 232 232 232 232 159 221 172 172 160 221 172 172 160 221 172 172 160 221 172 136 161 1 146 
146 1 135 172 172 172 161 137 219 134 196 215 226 226 146 395 394 395 394 197 196 395 394 395 394 146 232 232 232 232 232 232 232 232 232 232 232 232 232 232 232 232 232 232 232 232 146 1 1 146 
146 1 146 232 232 232 232 159 220 175 172 172 172 172 146 196 197 196 197 196 197 196 197 196 197 146 232 232 232 232 232 232 232 232 232 232 232 232 232 232 232 232 232 232 232 232 146 1 1 146 
146 1 146 232 232 232 232 232 232 232 232 232 232 232 159 172 172 172 172 172 172 172 172 172 172 161 232 232 232 232 232 232 232 232 232 232 232 232 232 232 232 232 135 247 248 249 160 280 137 146 
146 1 146 232 232 232 232 232 232 232 232 232 232 232 232 232 232 232 232 232 232 232 232 232 232 232 232 232 232 232 232 232 232 232 232 232 232 232 232 232 232 232 146 250 251 252 257 232 146 146 
146 135 222 222 222 222 222 222 222 222 137 232 232 232 232 232 232 232 232 232 232 232 232 232 232 232 232 232 232 232 135 172 172 172 172 172 219 172 137 232 232 232 193 232 232 232 232 232 146 146 
146 146 223 223 223 223 223 223 223 223 146 232 232 232 232 232 232 232 232 232 232 232 232 232 232 232 232 232 232 232 146 396 232 396 232 396 232 396 146 232 232 232 146 232 232 232 232 274 146 146 
146 146 423 167 186 167 167 186 167 167 146 232 232 232 135 426 427 426 427 428 429 426 427 428 429 137 232 232 232 232 146 232 232 232 232 232 232 232 146 232 232 232 146 232 232 232 232 274 146 146 
146 146 423 167 186 167 167 186 167 167 219 232 232 232 146 224 225 225 225 225 225 225 225 225 229 146 232 232 232 232 146 232 232 232 232 232 232 232 146 232 232 232 146 400 232 232 232 274 146 146 
146 146 423 167 186 167 167 186 167 167 146 232 232 232 146 167 167 167 167 167 167 167 167 167 422 146 232 232 232 232 146 217 232 217 232 217 232 217 146 232 232 232 146 400 400 232 232 275 146 146 
146 146 423 167 167 167 167 167 167 422 146 232 232 232 146 424 430 430 430 167 167 434 434 434 434 146 232 232 232 232 146 218 232 218 232 218 232 218 146 232 232 232 146 224 225 225 225 229 146 146 
146 159 172 172 172 172 172 172 172 172 161 232 232 232 146 425 167 167 167 167 167 167 167 167 167 146 172 172 172 172 172 172 172 172 172 172 172 172 149 232 232 232 159 172 172 172 136 172 161 146 
146 1 146 232 232 232 232 232 232 232 232 232 232 232 146 433 433 433 433 167 167 424 432 432 432 146 403 1 1 401 402 415 415 415 401 402 1 16 146 232 232 232 232 232 232 232 146 1 1 146 
146 1 146 232 232 232 232 232 232 232 232 232 232 232 146 167 167 167 167 167 167 425 167 167 422 146 404 2 2 1 1 2 1 1 1 2 1 1 146 232 232 232 232 232 232 232 146 1 1 146 
146 135 276 277 172 172 172 276 277 136 172 172 172 172 172 172 172 172 172 227 172 172 172 172 172 161 1 1 1 1 2 1 1 2 1 1 2 1 193 232 232 232 232 232 135 172 160 172 137 146 
146 146 278 279 258 259 260 278 279 146 16 2 1 1 1 2 1 1 1 1 2 1 2 1 1 1 2 1 2 2 1 1 2 1 1 1 1 1 146 232 232 232 232 232 146 0 0 0 146 146 
146 146 167 167 167 167 167 167 167 193 1 2 1 2 1 2 1 2 1 2 1 1 1 2 2 1 1 2 1 1 2 1 1 2 1 2 1 16 146 232 232 232 232 232 146 0 0 0 146 146 
146 159 137 270 167 167 167 167 167 146 2 1 1 2 1 1 1 1 1 1 2 1 1 1 1 1 135 397 172 193 172 172 172 172 172 172 172 172 160 172 172 137 232 232 146 0 0 0 146 146 
146 1 146 271 167 224 225 225 229 147 172 193 172 397 172 172 172 172 172 172 137 1 2 1 1 2 146 398 167 167 167 191 420 191 420 191 420 191 420 191 420 146 232 232 146 0 0 0 146 146 
146 1 147 172 172 172 172 172 172 149 422 167 167 398 191 420 191 420 191 420 146 1 1 2 1 1 146 167 167 167 167 167 421 167 421 167 421 167 421 167 421 146 232 232 146 0 0 0 146 146 
146 1 146 0 0 0 0 0 0 146 187 167 167 167 167 421 167 421 167 421 146 16 1 1 1 16 146 187 167 167 167 167 167 167 167 167 167 167 167 167 167 146 232 232 146 0 0 0 146 146 
146 1 159 172 172 172 172 172 172 160 172 172 137 187 167 167 167 167 167 167 147 172 172 193 172 172 149 187 187 167 167 422 135 172 172 172 172 172 172 172 172 160 172 172 149 0 0 0 146 146 
146 1 1 1 1 1 1 1 1 1 1 1 159 172 172 172 172 172 172 172 161 1 1 1 1 1 159 172 172 172 172 172 161 1 1 1 1 1 1 1 1 1 1 1 159 172 172 172 161 146 
146 1 1 1 1 1 1 1 1 1 1 1 1 1 1 1 1 1 1 1 1 1 1 1 1 1 1 1 1 1 1 1 1 1 1 1 1 1 1 1 1 1 1 1 1 1 1 1 1 146 
146 1 1 1 1 1 1 1 1 1 1 1 1 1 1 1 1 1 1 1 1 1 1 1 1 1 1 1 1 1 1 1 1 1 1 1 1 1 1 1 1 1 1 1 1 1 1 1 1 146 
159 172 172 172 172 172 172 172 172 172 172 172 172 172 172 172 172 172 172 172 172 172 172 172 172 172 172 172 172 172 172 172 172 172 172 172 172 172 172 172 172 172 172 172 172 172 172 172 172 172 
