2 2 1 2 1 2 1 1 2 2 2 2 1 1 1 1 2 1 1 135 172 172 172 172 172 172 172 172 172 172 172 137 16 16 16 16 16 17 17 16 16 20 21 21 21 22 16 16 16 16 
1 2 233 233 233 233 233 233 233 233 233 233 233 233 233 1 1 2 1 146 34 34 34 34 34 35 35 34 34 34 34 146 16 16 16 16 17 17 17 17 16 23 18 18 18 24 16 16 16 16 
1 2 233 283 284 285 286 287 288 289 290 291 292 293 233 1 1 2 1 146 34 189 34 34 228 34 34 228 34 34 189 146 16 16 16 16 17 17 17 17 16 25 26 26 26 27 17 17 17 16 
2 2 233 294 295 296 297 298 299 300 301 302 303 304 233 2 1 2 1 146 34 34 34 34 34 34 34 34 34 34 34 146 16 16 16 16 17 17 17 17 17 17 17 17 17 17 17 17 17 16 
2 1 233 305 306 307 308 309 310 311 312 313 314 315 233 1 2 2 1 146 34 189 34 34 228 34 34 228 34 34 189 146 16 16 16 16 17 17 17 17 17 17 17 17 17 17 17 17 17 16 
2 1 233 316 317 318 319 320 321 322 323 324 325 326 233 1 2 2 1 146 34 34 34 34 34 34 34 34 34 34 34 146 16 16 16 16 16 16 16 17 17 17 17 17 16 16 17 17 17 16 
1 1 233 327 350 351 358 331 335 333 358 358 339 337 233 1 1 2 1 159 172 172 172 172 172 221 172 172 172 172 172 161 16 16 16 16 16 16 17 17 17 17 17 17 16 16 16 16 16 16 
2 2 233 338 339 340 341 342 343 344 345 346 347 348 233 1 1 2 1 1 1 2 1 2 1 1 1 1 1 1 16 16 16 16 16 16 16 17 17 17 17 17 17 16 16 16 16 16 16 16 
1 1 233 349 350 351 352 353 354 355 358 358 358 359 233 1 1 1 2 1 1 1 1 1 1 1 1 1 1 1 16 415 401 402 16 17 17 17 17 17 17 16 16 16 16 16 16 16 16 16 
2 1 233 360 361 362 363 364 365 366 367 368 369 370 221 1 2 1 1 1 1 1 2 1 1 1 1 1 1 1 16 403 1 1 17 17 17 17 17 17 20 21 21 22 16 16 16 16 16 16 
1 2 233 371 372 373 374 375 376 377 378 379 380 381 233 1 1 1 1 1 1 2 2 1 2 1 2 2 1 1 16 404 1 17 17 17 17 17 16 16 23 18 18 24 16 16 16 16 16 16 
1 2 233 382 383 384 385 386 387 388 389 390 391 392 233 1 1 1 1 1 1 1 1 2 2 2 2 2 2 1 16 16 17 17 17 17 1 16 16 16 25 26 26 27 16 16 16 16 16 16 
2 1 233 233 221 233 233 233 233 233 233 233 233 233 233 1 1 1 2 1 1 1 2 2 2 1 1 1 2 1 1 1 1 17 17 16 16 16 16 16 16 16 16 16 16 16 16 16 16 16 
2 1 1 2 1 1 2 1 2 1 1 1 2 1 2 1 1 2 2 1 1 2 2 2 1 1 2 1 1 2 1 1 1 1 1 1 1 1 1 1 1 1 1 1 1 1 1 1 1 1 
1 1 1 1 1 1 1 1 1 1 1 1 1 2 2 1 2 2 1 1 1 1 1 1 1 1 1 1 1 1 1 1 1 2 1 1 1 1 1 1 1 1 1 1 1 1 1 1 1 1 
2 2 1 2 1 1 1 1 1 2 1 2 1 1 1 2 2 1 1 1 1 1 1 1 1 1 1 1 1 1 1 1 1 1 1 1 2 1 135 172 172 172 172 172 172 172 172 172 172 137 
1 1 1 2 2 2 1 1 1 1 1 2 1 1 2 2 135 199 194 172 172 136 172 172 172 172 172 136 172 172 173 137 1 1 2 1 1 1 146 281 282 281 282 281 282 281 282 281 282 146 
1 1 1 1 1 1 1 2 2 1 1 2 1 2 2 1 146 198 195 196 197 146 197 196 197 196 197 146 0 0 0 146 1 1 1 1 2 1 146 282 281 282 281 282 281 282 281 282 281 146 
172 172 172 172 172 172 172 172 137 1 2 2 1 1 1 1 146 197 196 197 196 219 196 197 196 197 196 227 0 0 0 146 1 1 1 2 2 1 146 281 282 281 282 142 145 281 282 281 282 146 
182 191 167 167 182 191 167 167 221 1 2 2 2 2 2 1 146 196 197 196 217 146 197 196 197 196 197 146 0 0 0 146 1 1 2 2 1 1 146 282 281 282 281 154 157 282 281 282 281 146 
183 167 167 167 183 167 167 167 146 1 2 2 2 2 1 1 146 197 196 197 218 146 213 226 226 226 226 159 172 172 172 149 1 1 1 1 1 1 146 281 282 281 282 154 157 281 282 281 282 146 
167 167 167 167 167 167 167 184 146 1 1 2 2 2 2 1 147 172 219 172 172 161 197 196 197 196 197 196 197 196 197 146 1 1 1 1 1 1 221 282 281 282 281 154 157 282 281 282 281 146 
172 172 172 172 172 172 172 172 146 1 1 1 1 2 1 1 146 197 196 197 196 197 196 197 196 197 196 197 196 197 196 146 1 1 1 1 1 1 146 281 282 281 282 178 181 281 282 281 282 146 
182 191 167 167 182 191 167 167 221 1 2 1 2 2 1 1 146 196 197 196 395 394 395 394 197 196 395 394 395 394 197 146 1 1 1 1 1 1 146 282 281 282 281 282 281 282 281 282 281 146 
183 167 167 167 183 167 167 167 146 1 1 1 1 2 1 1 146 197 196 197 224 225 225 229 196 197 224 225 225 229 196 146 1 1 1 1 1 1 146 281 282 281 282 281 282 281 282 281 282 146 
167 167 167 167 167 167 167 184 146 2 1 1 2 2 2 1 146 196 197 196 395 394 395 394 197 196 395 394 395 394 197 146 1 1 1 1 1 1 159 172 172 172 172 172 172 172 172 172 172 161 
172 172 172 172 172 172 172 172 149 1 2 1 1 2 2 1 146 197 196 197 196 197 196 197 196 197 196 197 196 197 196 146 1 1 1 1 1 1 1 1 1 1 1 1 1 1 1 1 1 2 
182 191 167 167 182 191 167 167 221 1 2 2 2 2 2 1 146 196 197 196 395 394 395 394 197 196 395 394 395 394 197 146 1 1 1 1 1 1 1 1 1 1 1 1 1 1 1 1 1 1 
183 167 167 167 183 167 167 167 146 1 2 1 1 2 1 1 146 197 196 197 225 225 225 229 196 196 224 225 225 229 196 146 1 1 1 1 1 1 1 1 1 1 1 1 1 1 1 1 1 1 
167 167 167 167 167 167 167 184 146 1 1 2 2 1 2 1 146 196 197 196 395 394 395 394 197 196 395 394 395 394 197 146 1 1 1 1 1 1 1 1 1 135 201 172 172 172 172 172 201 137 
172 172 172 172 172 172 172 172 149 1 1 1 1 2 2 1 146 197 196 197 196 197 196 197 196 197 196 197 196 197 196 146 1 2 2 1 1 1 2 1 1 146 202 34 258 259 260 34 202 146 
182 191 167 167 182 191 167 167 221 1 2 2 2 1 1 1 159 172 172 172 172 172 172 172 221 221 172 172 172 172 172 161 1 1 2 1 2 2 2 2 1 193 34 34 34 34 34 34 34 146 
183 167 167 167 183 167 167 167 146 1 2 1 2 1 1 2 2 1 1 2 1 1 1 1 2 1 1 1 1 2 1 1 1 1 1 1 1 1 1 1 1 134 34 224 225 225 229 34 34 146 
167 167 167 167 167 167 167 184 146 1 1 2 1 1 2 1 1 2 1 1 2 1 2 1 2 1 2 1 1 1 1 2 1 2 1 1 1 135 172 172 172 148 172 172 172 172 222 222 222 149 
172 172 172 172 172 172 172 172 149 1 2 1 142 145 4 5 5 5 5 6 142 145 1 1 1 1 142 144 144 145 2 1 2 1 1 2 1 146 213 214 232 146 34 34 34 34 416 416 416 146 
182 191 167 167 182 191 167 167 221 2 1 1 178 181 7 415 401 402 415 8 178 181 2 2 1 2 178 179 179 181 1 2 1 2 2 2 1 146 232 232 232 219 34 34 34 34 34 34 417 146 
183 167 167 167 183 167 167 167 146 1 1 1 4 409 1 2 1 1 2 1 412 6 1 1 1 1 1 2 1 1 2 1 1 2 1 1 1 159 172 172 172 149 34 34 34 34 34 34 417 146 
167 167 167 167 167 167 167 184 146 1 2 1 7 410 2 1 2 1 1 1 413 8 2 2 1 2 1 1 1 1 1 1 2 2 1 2 2 1 1 1 16 146 34 34 34 34 34 34 417 146 
172 172 172 172 172 172 172 172 161 1 1 1 9 411 1 1 1 1 1 2 414 11 1 2 1 134 193 233 134 2 2 1 1 1 2 1 1 1 1 2 1 221 34 34 34 34 34 34 417 146 
1 2 1 1 2 1 1 2 1 1 1 2 142 145 7 415 407 408 415 8 142 145 2 1 2 146 167 167 146 2 1 2 2 1 1 1 2 1 2 1 1 146 34 34 34 34 34 34 34 146 
2 1 2 1 2 1 2 1 1 2 2 1 178 181 9 10 10 10 10 11 178 181 1 2 1 146 167 167 146 2 1 2 1 1 2 2 2 1 2 1 16 146 34 34 34 34 34 400 34 146 
1 2 1 2 1 1 2 1 2 1 1 2 1 2 1 1 1 2 1 1 1 1 2 1 2 146 167 167 146 415 2 1 1 2 1 1 1 2 1 16 16 146 35 34 34 34 34 400 400 146 
2 1 1 1 2 1 1 1 1 2 1 1 1 1 1 2 1 1 1 2 1 1 1 135 172 161 204 205 159 280 172 172 172 137 2 1 2 2 135 397 172 160 201 172 219 172 136 227 172 149 
135 172 221 233 233 233 172 137 1 1 1 2 1 2 1 1 1 2 1 1 1 2 1 146 187 167 167 167 167 167 258 259 260 146 1 2 1 1 146 398 400 400 202 34 34 34 146 0 0 146 
146 167 167 167 167 167 167 147 172 221 233 233 172 172 136 172 221 233 233 172 137 16 16 146 167 167 167 167 167 167 167 167 167 146 1 2 2 1 146 34 34 34 34 34 34 34 146 0 0 146 
146 182 167 167 167 167 182 146 167 167 167 167 167 167 146 167 167 167 167 167 146 16 16 146 167 209 211 167 167 209 211 167 167 146 2 1 1 2 146 34 34 34 34 34 34 34 146 0 0 146 
146 183 167 167 167 167 183 146 182 167 167 167 167 182 146 182 167 167 167 182 146 16 16 146 167 210 212 167 167 210 212 167 167 146 1 2 2 1 146 34 34 34 34 34 34 34 146 0 0 146 
146 191 167 167 167 167 191 146 183 167 167 167 167 183 146 183 167 167 167 183 146 16 16 146 167 167 167 393 167 167 167 393 167 146 2 1 2 1 146 34 34 34 34 34 34 400 146 0 0 146 
146 167 167 167 184 167 167 146 191 167 167 184 167 191 146 191 167 184 167 191 146 16 16 146 167 224 225 225 225 225 225 225 229 146 1 2 1 2 146 34 224 225 229 34 400 400 146 0 0 146 
159 172 172 172 172 172 172 172 172 172 172 172 172 172 172 172 172 172 172 172 172 172 172 160 172 172 172 172 172 172 172 172 172 160 172 204 205 172 160 172 172 172 172 172 172 172 172 172 172 161 
